[
  {
    "type": "mapgen",
    "method": "json",
    "om_terrain": "implicit_cottage_base",
    "object": {
      "fill_ter": "t_floor",
      "palettes": [ "minimal" ],
      "rows": [
        "#####",
        "#...#",
        "#...#",
        "#...#",
        "#####"
      ]
    }
  },
  {
    "type": "mapgen",
    "method": "json",
    "om_terrain": "implicit_cottage_roof",
    "object": {
      "fill_ter": "t_wall",
      "rows": [
        "###",
        "###",
        "###"
      ]
    }
  }
]
