[
  {
    "type": "mapgen",
    "method": "json",
    "om_terrain": "test_room",
    "object": {
      "fill_ter": "t_floor",
      "palettes": [ "minimal" ],
      "rows": [
        "#####",
        "#...#",
        "#.H.#",
        "#...#",
        "#####"
      ]
    }
  }
]
