[
  {
    "type": "mapgen",
    "method": "json",
    "om_terrain": "test_update_base",
    "object": {
      "fill_ter": "t_floor",
      "rows": [
        "#####",
        "#...#",
        "#####"
      ],
      "terrain": {
        "#": "t_wall",
        ".": "t_floor"
      }
    }
  },
  {
    "type": "mapgen",
    "method": "json",
    "update_mapgen_id": "test_update_patch",
    "object": {
      "set": [
        { "point": "terrain", "id": "t_dirt", "x": 1, "y": 1 }
      ]
    }
  }
]
