[
  {
    "type": "mapgen",
    "method": "json",
    "om_terrain": [ [ "test_crop_west", "test_crop_east" ] ],
    "object": {
      "fill_ter": "t_floor",
      "palettes": [ "minimal" ],
      "rows": [
        "WWWWWWWWWWWWWWWWWWWWWWWWEEEEEEEEEEEEEEEEEEEEEEEE",
        "WWWWWWWWWWWWWWWWWWWWWWWWEEEEEEEEEEEEEEEEEEEEEEEE",
        "WWWWWWWWWWWWWWWWWWWWWWWWEEEEEEEEEEEEEEEEEEEEEEEE"
      ],
      "terrain": {
        "W": "t_wall",
        "E": "t_dirt"
      },
      "place_monster": [
        { "monster": "mon_west_bot", "x": 0, "y": 0, "chance": 100 },
        { "monster": "mon_east_bot", "x": 24, "y": 0, "chance": 100 }
      ]
    }
  }
]
