[
  {
    "type": "mapgen",
    "method": "json",
    "nested_mapgen_id": "test_nested_room",
    "object": {
      "mapgensize": [ 12, 12 ],
      "fill_ter": "t_floor",
      "rows": [
        "############",
        "#..........#",
        "#..........#",
        "#..........#",
        "#..........#",
        "#..........#",
        "#..........#",
        "#..........#",
        "#..........#",
        "#..........#",
        "#..........#",
        "############"
      ],
      "terrain": {
        "#": "t_wall",
        ".": "t_floor"
      }
    }
  }
]
