[
  {
    "type": "mapgen",
    "method": "json",
    "om_terrain": "test_setmap_buffer",
    "object": {
      "fill_ter": "t_grass",
      "rows": [
        "........................",
        "........................",
        "........................",
        "........................",
        "........................",
        "........................",
        "........................",
        "........................",
        "........................",
        "........................",
        "........................",
        "........................",
        "........................",
        "........................",
        "........................",
        "........................",
        "........................",
        "........................",
        "........................",
        "........................",
        "........................",
        "........................",
        "........................",
        "........................"
      ],
      "set": [
        {
          "point": "terrain",
          "id": "t_dirt",
          "x": [ 0, 23 ],
          "y": [ 0, 23 ],
          "repeat": [ 50, 50 ],
          "chance": 1
        },
        {
          "square": "terrain",
          "id": "t_wall",
          "x": 10,
          "y": 10,
          "x2": 12,
          "y2": 12
        }
      ]
    }
  }
]
