[
  {
    "type": "mapgen",
    "method": "json",
    "nested_mapgen_id": "test_nested_neighbor_room",
    "object": {
      "mapgensize": [ 4, 4 ],
      "fill_ter": "t_floor",
      "rows": [
        "####",
        "#..#",
        "#..#",
        "####"
      ],
      "terrain": {
        "#": "t_wall",
        ".": "t_floor"
      }
    }
  }
]
